............................................................................................................................................................................................................................................................................................................................................
............................................................................................................................................................................................................................................................................................................................................
............................................................................................................................................................................................................................................................................................................................................
............................................................................................................................................................................................................................................................................................................................................
............................................................................................................................................................................................................................................................................................................................................
............................................................................................................................................................................................................................................................................................................................................
............................................................................................................................................................................................................................................................................................................................................
............................................................................................................................................................................................................................................................................................................................................
............................................................................................................................................................................................................................................................................................................................................
............................................................................................................................................................................................................................................................................................................................................
............................................................................................................................................................................................................................................................................................................................................
............................................................................................................................................................................................................................................................................................................................................
............................................................................................................................................................................................................................................................................................................................................
............................................................................................................................................................................................................................................................................................................................................
............................................................................................................................................................................................................................................................................................................................................
........................................................................................................................................................................................*....................*..................*...........................................................................................................
............................................................................................................................................................................./////////////////////////////////////////////////////////.....................................................................................................%
................................................................................................................................................*..................///////////////////////////////////////////////////////////////////.....................................................................................................%
.....@.................*...............*...............*....................*.......*......*.......*..............................////////////////////////////////////////////////////////////////////////////////////////////////////................*..........................*...................*..........*..........................%
############################################################################################################################################################################################################################################################################################################################################